.┏----┓┏┓┏┓┏┓┏-┓....
.|┏--┓||||||||┏┛....
.||.┏┛||||||||┗┓....
┏┛┗┓┗┓┗┛┗┛||┗┛.┗-┓..
┗--┛.┗┓...┗┛S┓┏-┓┗┓.
....┏-┛..┏┓┏┛|┗┓┗┓┗┓
....┗┓.┏┓||┗┓|.┗┓┗┓|
.....|┏┛┗┛|┏┛|┏┓|.┗┛
....┏┛┗-┓.||.||||...
....┗---┛.┗┛.┗┛┗┛...